NO texture/bluewall.xpm
SO texture/yellowwall.xpm
WE texture/greenwall.xpm
EA texture/orangewall.xpm
F 50,200,200
C 2,100,0

111111111111111111111111111111111111111111111111111111111111111111111111111111111111111111111111111
100000000000000000000000000000000000000000000000000000000000000000000000000000000000000000000000001
100000000000000000000000000000000000000000000000000000000000000000000000000000000000000000000000001
100000000000000000000000000000000000000000000000000000000000000000000000000000000000000000000000001
100000000000000000000000000000000000000000000000000000000000000000000000000000000000000000000000001
100000000000000000000000000000000000000000011100111000000000000000000000000000000000000000000000001
100000000000000000000000000000000000000000011100111000000000000000000000000000000000000000000000001
100000000000000000000000000000000000000000011100111000000000000000000000000000000000000000000000001
100000000000000000000000S00000000000000000011100111000000000000000000000000000000000000000000000001
100000000000000000000000000000000000000000000000000000000000000000000000000000000000000000000000001
100000000000000000000000000000000000000000011100111000000000000000000000000000000000000000000000001
100000000000000000000000000000000000000000011100111000000000000000000000000000000000000000000000001
100000000000000000000000000000000000000000011100111000000000000000000000000000000000000000000000001
100000000000000000000000000000000000000000000000000000000000000000000000000000000000000000000000001
100000000000000000000000000000000000000000000000000000000000000000000000000000000000000000000000001
100000000000000000000000000000000000000000000000000000000000000000000000000000000000000000000000001
100000000000000000000000000000000000000000000000000000000000000000000000000000000000000000000000001
100000000000000000000000000000000000000000000000000000000000000000000000000000000000000000000000001
100000000000000000000000000000000000000000000000000000000000000000000000000000000000000000000000001
100000000000000000000000000000000000000000000000000000000000000000000000000000000000000000000000001
100000000000000000000000000000000000000000000000000000000000000000000000000000000000000000000000001
100000000000000000000000000000000000000000011111111000000000000000000000000000000000000000000000001
100000000000000000000000000000000000000000011111111000000000000000000000000000000000000000000000001
100000000000000000000000000000000000000000011111111000000000000000000000000000000000000000000000001
100000000000000000000000000000000000000000011111111000000000000000000000000000000000000000000000001
100000000000000000000000000000000000000000011111111000000000000000000000000000000000000000000000001
100000000000000000000000000000000000000000011111111000000000000000000000000000000000000000000000001
100000000000000000000000000000000000000000011111111000000000000000000000000000000000000000000000001
100000000000000000000000000000000000000000011111111000000000000000000000000000000000000000000000001
100000000000000000000000000000000000000000000000000000000000000000000000000000000000000000000000001
100000000000000000000000000000000000000000000000000000000000000000000000000000000000000000000000001
100000000000000000000000000000000000000000000000000000000000000000000000000000000000000000000000001
100000000000000000000000000000000000000000000000000000000000000000000000000000000000000000000000001
100000000000000000000000000000000000000000000000000000000000000000000000000000000000000000000000001
100000000000000000000000000000000000000000000000000000000000000000000000000000000000000000000000001
100000000000000000000000000000000000000000000000000000000000000000000000000000000000000000000000001
100000000000000000000000000000000000000000011111111000000000000000000000000000000000000000000000001
100000000000000000000000000000000000000000011111111000000000000000000000000000000000000000000000001
100000000000000000000000000000000000000000011111111000000000000000000000000000000000000000000000001
100000000000000000000000000000000000000000011111111000000000000000000000000000000000000000000000001
100000000000000000000000000000000000000000011111111000000000000000000000000000000000000000000000001
100000000000000000000000000000000000000000011111111000000000000000000000000000000000000000000000001
100000000000000000000000000000000000000000011111111000000000000000000000000000000000000000000000001
100000000000000000000000000000000000000000011111111000000000000000000000000000000000000000000000001
100000000000000000000000000000000000000000000000000000000000000000000000000000000000000000000000001
100000000000000000000000000000000000000000000000000000000000000000000000000000000000000000000000001
100000000000000000000000000000000000000000000000000000000000000000000000000000000000000000000000001
111111111111111111111111111111111111111111111111111111111111111111111111111111111111111111111111111
