NO texture/bluewall.xpm
SO texture/yellowwall.xpm
WE texture/greenwall.xpm
EA texture/orangewall.xpm
F 220,100,0
C 225,30,0

11111     11111
10101     10101
10001     10N01
11111     11111
     11111
111111111111111
10000000000000
100011111110001
11111     11111