NO texture/bluewall.xpm
SO texture/yellowwall.xpm
WE texture/greenwall.xpm
EA texture/orangewall.xpm
F 50,200,200
C 2,100,0

11111     11111
10101     1N101
10001     10001
11111     11111
     11111
111111111111111
100000000000001
100011111110001
11111     11111
