NO texture/NO.xpm
SO texture/SO.xpm
WE texture/WE.xpm
EA texture/EA.xpm
F 50,200,200
C 2,100,0

        1111111111111111111111111
        1000000000110000000000001
        1011000001110000000000001
        1001000000000000000000001
111111111011000001110000000000001
100000000011000001110111111111111
11110111111111011100000010001    
11110111111111011101010000001    
11000000110101011100000010001    
1000000000100000110000001000111   
1000000000100000110101001000001    
11000001110101011111011110S0011  
11110111 1110101 1011110100011  
11111111 1111111 111111111111  
