NO texture/wall.xpm
SO texture/wall.xpm
WE texture/wall.xpm
EA texture/wall.xpm
F 50,200,200
C 2,100,0

111111111111111111111111111111111111111111111111111111111111111111111111111111111111111111111111111
100000000000000000000000000000000000000000000000000000000000000000000000000000000000000000000000001
100000000000000000000000000000000000000000000000000000000000000000000000000000000000000000000000001
100000000000000000000000000000000000000000000000000000000000000000000000000000000000000000000000001
100000000000000000000000000000000000000000000000000000000000000000000000000000000000000000000000001
100000000000000000000000000000000000000000011111111000000000000000000000000000000000000000000000001
100000000000000000000000000000000000000000011111111000000000000000000000000000000000000000000000001
100000000000000000000000000000000000000000011111111000000000000000000000000000000000000000000000001
100000000000000000000000N00000000000000000011111111000000000000000000000000000000000000000000000001
100000000000000000000000000000000000000000011111111000000000000000000000000000000000000000000000001
100000000000000000000000000000000000000000011111111000000000000000000000000000000000000000000000001
100000000000000000000000000000000000000000011111111000000000000000000000000000000000000000000000001
100000000000000000000000000000000000000000011111111000000000000000000000000000000000000000000000001
100000000000000000000000000000000000000000000000000000000000000000000000000000000000000000000000001
100000000000000000000000000000000000000000000000000000000000000000000000000000000000000000000000001
100000000000000000000000000000000000000000000000000000000000000000000000000000000000000000000000001
100000000000000000000000000000000000000000000000000000000000000000000000000000000000000000000000001
111111111111111111111111111111111111111111111111111111111111111111111111111111111111111111111111111
