NO texture/brick.xpm
SO texture/brick.xpm
WE texture/stone.xpm
EA texture/stone.xpm
F 255,255,255
C 175,100,50

   111111
11110000111111111
100100000000000011111111
100001100N00001111000001
110011000000000110000001
100001000000001111100001
110001000011101110001111
111001000000001000011111
111101000000000000011111
   1000000000000000111
   11111000011111111
    11111111111